4
NNNNNNNNNNNNNNNNNNNNN
WTTTTTTTTTTTTTTTTTTTE
WTTTTTTTTTTTTTTTTTTTE
WTTTTTTTTTTTTTTTTTTTE
WTTTTTTTTTTTTTTTTTTTE
WTTTTTTTTTTTTTTTTTTTE
T...................T
TP................g.T
T...................T
WTTTTTTTTTTTTTTTTTTTE
SSSSSSSSSSSSSSSSSSSSS
