0
NNNNNNNNNNNNNNNNNNNNN
WTTTTTd..........dTTE
WTTTTd..........dTTTE
WTTd...........dTTTTE
WTd...........dTTTTTE
Wd...........dTTTTTTE
WTTTTTTTTTTTTTTTTTTTE
WTTTTTTTTTTTTTTTTTTTE
WTTTTTTTTTTTTTTTTTTTE
WTTTTTTTTTTTTTTTTTTTE
SSSSSSSSSSSSSSSSSSSSS
