1
NNNNNNNNNNNNNNNNNNNNN
WT.........TTTTTTTTTE
WT....B....T....d...E
WT.........T........E
WT..d.h#.d.T..T..d..E
WT....##...T..T.....E
WT..d......T..T.....E
WT......TTTT..T.....E
WT............TTTTTTE
WTTTTTTTTTTTTTTTTTTTE
SSSSSSSSSSSSSSSSSSSSS
