0
NNNNNNNNNNNNNNNNNNNNN
WTTTd...........dTTTE
WTTd.............dTTE
W....h#.......h#....E
W....##..F##..##....E
W........###........E
W....h#..###..h#....E
WTd..##...V...##..dTE
WTTd......P......dTTE
WTTTd...........dTTTE
SSSSSSSSSSSSSSSSSSSSS
