3
NNNNNNNNNNNNNNNNNNNNN
WTTTTTTTTTTTTTTTTTTTE
WTTTTTTTTTTTTTTTTTTTE
WTTTTTv.....TTTTTTTTE
WTTTTTT...T........TE
WTTTTTTTT.TTTTTTTT.TE
WT........T........TE
WT.TTTTTTTT.TTTTTTTTE
WT........T.TTTTTTTTE
WTTTTTTTT.T.TTTTTTTTE
SSSSSSSSSSSSSSSSSSSSS
