1
NNNNNNNNNNNNNNNNNNNNN
WTTTTTTTTTTTTTTTTTTTE
WTTTTTTTTTTTTTTTTTTTE
W......d..TTTTTTTTTTE
W.d......TTTTTTTTTTTE
WT...TaTTTTTTTTTTTTTE
WTTTT...TTTTTTTTTTTTE
WTTT.....TTTTTTTTTTTE
WTT.....d.TTTTTTTTTTE
WT.........TTTTTTTTTE
SSTTTTTTTTTTSSSSSSSSS
