4
NNNNNNNNNNNNNNNNNNNNN
WTTTTTTTTTTTTTTTTTTTE
WTTTTTTTTTTTTTTTTTTTE
WTTTTTTTTTTTTTTTTTTTE
TTTTTT.........TTTTTT
TTTTTT....O....TTTTTT
TTTTTT.........TTTTTT
WTTTTTTTT...TTTTTTTTE
WTTTTTTTT...TTTTTTTTE
WTTTTTTTT.P.TTTTTTTTE
WTTTTTTTTTTTTTTTTTTTE
