0
NNNNNNNNNNNNNNNNNNNNN
WTTTTTTTTTTTTTTTTTTTE
WTTTTTTTTH#TTTTTTTTTE
W..T.....##....TTTTTE
W...d.....y.....TTTTE
W....TT......d....d.E
W........d......TTTTE
WTTTTTTTTTTTTTTTTTTTE
WTTTTTTTTTTTTTTTTTTTE
WTTTTTTTTTTTTTTTTTTTE
SSSSSSSSSSSSSSSSSSSSS
