0
NNNNNNNNNNNNNNNNNNNNN
WTTTTTTTTTTTTTTTTTTTE
WTTTTTTTTTTTTTTTTTTTE
WTTTTTTTTTTTTTTT....E
WTTTTTTTTTTTTT......E
WTPGdddddddddd......E
WTTTTTTTTTTTTT......E
WTTTTTTTTTTTTTTT....E
WTTTTTTTTTTTTTTTTTTTE
WTTTTTTTTTTTTTTTTTTTE
SSSSSSSSSSSSSSSSSSSSS
