3
NNNNNNNNNNNNNNNNNNNNN
WTTTTTTTT.T.TTTTTTTTE
WTT...d...T.T.....TTE
W...TT.T..T...T.T.TTE
W...T..T.TTTTTT.T..TE
W.d..TTT..T...d.TT.TE
W....TTTT.T.TTTTTT.TE
WTT...TT.TT.TTTTTTTTE
WTTTT..T.Tb...d.....E
WTTTTTTTTTTTTTTTTTTTE
SSSSSSSSSSSSSSSSSSSSS
