2
NNNNNNNNNNNNNNNNNNNNN
WTTTTTTTTTTTTTTTTTTTT
T.T.T.T.T.T.T.T.T.T.T
T..T.T.T.T.T.T.T.T..T
Td.d.d.d.d.d.d.dTCEET
TPd.d.d.d.d.d.d.dEEET
Td.d.d.d.d.d.d.dTEEET
T..T.T.T.T.T.T.T.T..T
T.T.T.T.T.T.T.T.T.T.T
WTTTTTTTTTTTTTTTTTTTE
SSSSSSSSSSSSSSSSSSSSS
