0
NNNNNNNNNNNNNNNNNNNNN
WTTTTTTTTTTTTTTTTTTTT
WTddTTdddddddddTTddTE
WTddTTTTTTTTTTTTTddTE
WTddTT..TCNNT..TTddTE
WT......TNNNT......TE
WTddTT..TNNNT..TTddTE
WTddTT.........TTddTE
WTTTTTTT.....TTTTTTTE
WTTT.............TTTE
SSSSSSSSSSSSSSSSSSSSS
